Minotaur’s Lair
20 10
####################
#                  #
#   ######         #
#   #    #         #
#   # S  #   M     #
#   ######         #
#                  #
#   ###########    #
#                  #
####################
